1111111111111111111
1C100C000010C0100E1
1010111110101010011
1P00100000001C00011
1111111111111111111