1111111111111111111111111111
10000001000011000000C0000E11
1000H00C0000000000000C000001
100000010000011000000C000001
110001111100000000000C000001
111001111100111000000C000001
100000010000000000000C000001
1000000C0000001000000C000001
10P000010000001000000C000001
1111111111111111111111111111